Hello: Hallo
Good morning: Guten Morgen
Monday: Montag
Tuesday: Dienstag
Wednesday: Mittwoch
Thursday: Donnerstag
Friday: Freitag
Saturday: Samstag
Sunday: Sonntag
Right: Richtig
Excuse me: Entschuldigung
I'm sorry: Tut mir leid
Big: Gross
Small: Klein
Together: Zusammen
Also: Auch
Great: Toll
Name: Vorname
Last name: Nachname
What's up?: Wie geht's?
Yo soy: Ich bin
Tú eres: Du bist
Él es: Er ist
Nosotros somos: Wir sind
Vosotros sois: Ihr seid
Ellos son: Sie sind
Herman@s: Geschwister
Hermanos: Brüder
Hermanas: Schwestern
Hermano: Bruder
Hermana: Schwester
: