Hello: Hallo
Good morning: Guten Morgen
Good afternoon: Guten Tag
Good evening: Guten Abend
Good night: Gute Nacht
Que tengas un buen día: Schönen Tag noch
Que tengas una buena tarde (2): Schönen Abend / Schönen Nachmittag
Que tengas un buen finde: Schönen Wochenende
Hasta luego: Bis später
Hasta mañana: Bis morgen
It fits: Es passt
Juntos: Zusammen
El finde: Das Wochenende
The Monday: Der Montag
The Tuesday: Der Dienstag
The Wednesday: Der Mittwoch
The Thursday: Der Donnerstag
The Friday: Der Freitag
The Saturday: Der Samstag
The Sunday: Der Sonntag
Right: Richtig
False: Falsch
El profesor: Der Lehrer
La profesora: Die Lehrerin
Excuse me: Entschuldigung
I'm sorry: Tut mir leid
Unfortunately: Leider
El significado: Die Bedeutung
El país: Das Land
La dirección: Die Adresse
La calle: Die Strasse
La ciudad (2): Die Stadt / Der Ort
El código postal: Die Postleitzahl
Casado: Verheiratet
Divorciado: Geschieden
Viudo: Verwitwet
El número (de casa): Die Hausnummer
Adiós: Tschüs
Adiós (ver): Auf Wiedersehen
Adiós (escuchar): Auf Wiederhören
Bienvenido: Willkommen
Calurosa bienvenida: Herzlich Willkommen
El ejercicio: Die Übung
La página: Die Seite
El diálogo: Das Gespräch
Los deberes de casa: Die Hausaufgabe
La pregunta: Die Frage
La respuesta: Die Antwort
La palabra: Das Wort
La letra: Der Buchstabe
Formal: Formell
Informal: Informell
Big: Gross
Small: Klein
La repetición: Die Wiederholung
El miembro de la familia: Das Familienmitglied
Los miembros de la familia: Die Familienmitglieder
Eso es!: Stimmt!
Exactamente: Genau
Mi: mein / meine
Tu: dein / deine
Su: ihr / ihre
El tema: Das Thema
Nuevo: Neu
Nuevo tema: Neues Thema
Muy: Sehr
También: Auch
Pero: Aber
Muchas gracias: Danke schön
De nada: Gern geschehen
El final: Das Ziel
Great: Toll
Agradable / ameno: Angenehm
Deletrea por favor: Buchstabieren bitte
The Name: Der Vorname
The last name: Der Nachname
Qué tal estás? Muy bien: Wie geht's? Sehr gut
Qué tal estás? Yo estoy bien: Wie geht's? Mir geht's gut
Qué tal estás? Bueno, ahí voy: Wie geht's? Na ja, es geht
Qué tal estás? No muy bien: Wie geht's? Nicht so gut
Un placer: Freut mich
Un poco: Ein bisschen
Una vez más: noch einmal
Cómo te va?: Wie geht's dir?
Quién eres? Yo soy...: Wie heisst du? Ich heisse...
Cómo te llamas? Me llamo...: Wer bist du? Ich bin...
Cuál es tu nombre? Mi nombre es...: Wie ist dein Name? Mein Name ist...
Perdón, qué?: Wie bitte?
De dónde eres? Yo soy de...: Woher kommst du? Ich komme aus...
Qué idiomas hablas? Yo hablo...: Was sprichst du? Ich spreche...
Quién es? Ese es...: Wer ist das? Das ist...
Quién es? Ese soy yo: Wer ist das? Das bin ich
No sé: Ich weiss nicht
No lo sé: Ich weisses nicht
Qué es lo correcto?: Was ist richtig?
Qué significa...? (2): Was heisst...? / Was bedeutet...?
Los padres: Die Eltern
El padre (2): Der Vater / Der Papa
La madre (2): Die Mutter / Die Mama
Los abuelos: Die Grosseltern
El abuelo (2): Der Opa / Der Grossvater
La abuela (2): Die Oma / Die Grossmutter
Los Herman@s: Die Geschwister
Los Hermanos: Die Brüder
arroba: ät
El juego: Das Spiel
Las Hermanas: Die Schwestern
El Hermano: Der Bruder
La Hermana: Die Schwester
El hijo: Der Sohn
La hija: Die Tochter
El esposo / marido: Der Ehemann
La esposa / mujer: Die Ehefrau
El primo: Der Cousin
La prima: Die Cousine
El nieto: Der Enkel
La nieta: Die Enkelin
El hombre: Der Mann
La mujer: Die Frau
ä / ö / ü (con puntos): a-umlaut
(ser / estar): (sein) ich bin, du bist, er ist, wir sind, ihr seid, sie sind
Yo soy: Ich bin
Tú eres: Du bist
Él es: Er ist
Nosotros somos: Wir sind
Vosotros sois: Ihr seid
Ellos son: Sie sind
(llamarse): (heissen) ich heisse, du heisst, er heisst, wir heissen, ihr heisst, sie heissen
Yo me llamo: Ich heisse
Tu te llamas: Du heisst
Él se llama: Er heisst
Nosotros nos llamamos: Wir heissen
Vosotros os llamáis: Ihr heisst
Ellos se llaman: Sie heissen
(ser de): (kommen) ich komme, du kommst, er kommt, wir kommen, ihr kommt, sie kommen
Yo soy de: Ich komme
Tú eres de: Du kommst
Él es de: Er kommt
Nosotros somos de: Wir kommen
Vosotros sois de: Ihr kommt
Ellos son de: Sie kommen
(hablar): (sprechen) ich spreche, du sprichst, er spricht, wir sprechen, ihr sprecht, sie sprechen
Yo hablo: Ich spreche
Tú hablas: Du sprichst
Él habla: Er spricht
Nosotros hablamos: Wir sprechen
Vosotros habláis: Ihr sprecht
Ellos hablan: Sie sprechen
(deletrear): (buchstabieren) ich buchstabiere, du buchstabierst, er buchstabiert, wir buchstabieren, ihr buchstabiert, sie buchstabieren
Yo deletreo: Ich buchstabiere
Tú deletreas: Du buchstabierst
Él deletrea: Er buchstabiert
Nosotros deletreamos: Wir buchstabieren
Vosotros deletreáis: Ihr buchstabiert
Ellos deletrean: Sie buchstabieren
(escuchar): (hören) ich höre, du hörst, er hört, wir hören, ihr hört, sie hören
Yo escucho: Ich höre
Tú escuchas: Du hörst
Él escucha: Er hört
Nosotros escuchamos: Wir hören
Vosotros escucháis: Ihr hört
Ellos escuchan: Sie hören
(conectar): (verbinden) ich verbinde, du verbindest, er verbindet, wir verbinden, ihr verbindet, sie verbinden
Yo conecto: Ich verbinde
Tú conectas: Du verbindest
Él conecta: Er verbindet
Nosotros conectamos: Wir verbinden
Vosotros conectáis: Ihr verbindet
Ellos conectan: Sie verbinden
(cruzar): (kreuzen) ich kreuze, du kreuzt, er kreuzt, wir kreuzen, ihr kreuzt, sie kreuzen
Yo cruzo: Ich kreuze
Tú cruzas: Du kreuzt
Él cruza: Er kreuzt
Nosotros cruzamos: Wir kreuzen
Vosotros cruzáis: Ihr kreuzt
Ellos cruzan: Sie kreuzen
(marcar con cruz): (ankreuzen) ich kreuze an, du kreuzt an, er kreuzt an, wir kreuzen an, ihr kreuzt an, sie kreuzen an
Yo marco: Ich kreuze an
Tú marcas: Du kreuzt an
Él marca: Er kreuzt an
Nosotros marcamos: Wir kreuzen an
Vosotros marcáis: Ihr kreuzt an
Ellos marcan: Sie kreuzen an
(comparar): (vergleichen) ich vergleiche, du vergleichst, er vergleicht, wir vergleichen, ihr vergleicht, sie vergleichen
Yo comparo: Ich vergleiche
Tú comparas: Du vergleichst
Él compara: Er vergleicht
Nosotros comparamos: Wir vergleichen
Vosotros comparáis: Ihr vergleicht
Ellos comparan: Sie vergleichen
(entender): (verstehen) ich verstehe, du verstehst, er versteht, wir verstehen, ihr versteht, sie verstehen
Yo entiendo: Ich verstehe
Tú entiendes: Du verstehst
Él entiende: Er versteht
Nosotros entendemos: Wir verstehen
Vosotros entendéis: Ihr versteht
Ellos entienden: Sie verstehen
(escribir): (schreiben) ich schreibe, du schreibst, er schreibt, wir schreiben, ihr schreibt, sie schreiben
Yo escribo: Ich schreibe
Tú escribes: Du schreibst
Él escribe: Er schreibt
Nosotros escribimos: Wir schreiben
Vosotros escribís: Ihr schreibt
Ellos escriben: Sie schreiben
(preguntar): (fragen) ich frage, du fragst, er fragt, wir fragen, ihr fragt, sie fragen
Yo pregunto: Ich frage
Tú preguntas: Du fragst
Él pregunta: Er fragt
Nosotros preguntamos: Wir fragen
Vosotros preguntáis: Ihr fragt
Ellos preguntan: Sie fragen
(decir): (sagen) ich sage, du sagst, er sagt, wir sagen, ihr sagt, sie sagen
Yo digo: Ich sage
Tú dices: Du sagst
Él dice: Er sagt
Nosotros decimos: Wir sagen
Vosotros decís: Ihr sagt
Ellos dicen: Sie sagen
(ir): (gehen) ich gehe, du gehst, er geht, wir gehen, ihr geht, sie gehen
Yo voy: Ich gehe
Tú vas: Du gehst
Él va: Er geht
Nosotros vamos: Wir gehen
Vosotros vais: Ihr geht
Ellos van: Sie gehen
(tener): (haben) ich habe, du hast, er hat, wir haben, ihr habt, sie haben
Yo tengo: Ich habe
Tú tienes: Du hast
Él tiene: Er hat
Nosotros tenemos: Wir haben
Vosotros tenéis: Ihr habt
Ellos tienen: Sie haben
: